NO ./Textures/north3.png
SO ./Textures/south2.png
WE ./Textures/west2.png
EA ./Textures/east2.png
F 0,0,0
C 0,0,0
        1111111111111111111111111
        10000000000P0000000000001
        1011000001110000000S00001
        1001000000000000000000001
111111111011000001110000000000001
1000000000110000011101111P1111111
11110111111111011100000010001
11110111111111011101010010001
11000000110101011100000010001
10000000000000001100000010001
10000000000000001101010010001
1100000111010101111101111010111
11110111 1110101 101111010001
11111111 1111111 111111111111


